"filename", "language", "Python", "comment", "blank", "total"
"c:\work\Python Projects\helper\pygame_helper\_utils.py", "Python", 12, 13, 4, 29
"c:\work\Python Projects\helper\pygame_helper\classes\background.py", "Python", 24, 18, 11, 53
"c:\work\Python Projects\helper\pygame_helper\classes\effects\particles.py", "Python", 203, 39, 62, 304
"c:\work\Python Projects\helper\pygame_helper\classes\effects\trail.py", "Python", 43, 21, 17, 81
"c:\work\Python Projects\helper\pygame_helper\classes\geometry\circle.py", "Python", 108, 57, 33, 198
"c:\work\Python Projects\helper\pygame_helper\classes\geometry\lines.py", "Python", 190, 117, 62, 369
"c:\work\Python Projects\helper\pygame_helper\classes\geometry\ray.py", "Python", 52, 46, 16, 114
"c:\work\Python Projects\helper\pygame_helper\classes\pathfinding.py", "Python", 79, 37, 18, 134
"c:\work\Python Projects\helper\pygame_helper\classes\sprites\animated.py", "Python", 193, 60, 44, 297
"c:\work\Python Projects\helper\pygame_helper\classes\sprites\components.py", "Python", 51, 3, 11, 65
"c:\work\Python Projects\helper\pygame_helper\classes\sprites\groups.py", "Python", 58, 17, 15, 90
"c:\work\Python Projects\helper\pygame_helper\classes\sprites\sprite.py", "Python", 187, 72, 44, 303
"c:\work\Python Projects\helper\pygame_helper\classes\timers.py", "Python", 36, 28, 11, 75
"c:\work\Python Projects\helper\pygame_helper\classes\ui\buttons.py", "Python", 83, 24, 29, 136
"c:\work\Python Projects\helper\pygame_helper\classes\ui\group.py", "Python", 47, 0, 8, 55
"c:\work\Python Projects\helper\pygame_helper\classes\ui\image.py", "Python", 20, 0, 8, 28
"c:\work\Python Projects\helper\pygame_helper\classes\ui\inputbox.py", "Python", 102, 30, 14, 146
"c:\work\Python Projects\helper\pygame_helper\classes\ui\statusbar.py", "Python", 77, 0, 17, 94
"c:\work\Python Projects\helper\pygame_helper\classes\ui\text.py", "Python", 77, 9, 18, 104
"c:\work\Python Projects\helper\pygame_helper\classes\ui\window.py", "Python", 2, 0, 1, 3
"c:\work\Python Projects\helper\pygame_helper\events\events.py", "Python", 62, 21, 15, 98
"c:\work\Python Projects\helper\pygame_helper\events\input.py", "Python", 13, 0, 2, 15
"c:\work\Python Projects\helper\pygame_helper\graphics\color.py", "Python", 317, 38, 17, 372
"c:\work\Python Projects\helper\pygame_helper\graphics\surface.py", "Python", 50, 11, 13, 74
"c:\work\Python Projects\helper\pygame_helper\graphics\utils.py", "Python", 24, 31, 4, 59
"c:\work\Python Projects\helper\pygame_helper\graphics\window.py", "Python", 26, 20, 8, 54
"c:\work\Python Projects\helper\pygame_helper\helper.py", "Python", 67, 24, 14, 105
"c:\work\Python Projects\helper\pygame_helper\saving.py", "Python", 71, 25, 7, 103
"c:\work\Python Projects\helper\pygame_helper\test.py", "Python", 14, 0, 10, 24
"Total", "-", 2288, 761, 533, 3582