"filename", "language", "Python", "Markdown", "comment", "blank", "total"
"c:\work\Python Projects\helper\pygame_helper\README.md", "Markdown", 0, 1, 0, 1, 2
"c:\work\Python Projects\helper\pygame_helper\__init__.py", "Python", 0, 0, 0, 1, 1
"c:\work\Python Projects\helper\pygame_helper\classes\__init__.py", "Python", 0, 0, 0, 1, 1
"c:\work\Python Projects\helper\pygame_helper\classes\animations\animation_action.py", "Python", 45, 0, 14, 5, 64
"c:\work\Python Projects\helper\pygame_helper\classes\animations\animation_step.py", "Python", 28, 0, 11, 7, 46
"c:\work\Python Projects\helper\pygame_helper\classes\animations\transform_animation.py", "Python", 101, 0, 37, 18, 156
"c:\work\Python Projects\helper\pygame_helper\classes\effects\__init__.py", "Python", 0, 0, 0, 1, 1
"c:\work\Python Projects\helper\pygame_helper\classes\effects\particles.py", "Python", 0, 0, 20, 1, 21
"c:\work\Python Projects\helper\pygame_helper\classes\effects\trail.py", "Python", 0, 0, 10, 0, 10
"c:\work\Python Projects\helper\pygame_helper\classes\geometry\__init__.py", "Python", 0, 0, 0, 1, 1
"c:\work\Python Projects\helper\pygame_helper\classes\geometry\circle.py", "Python", 0, 0, 9, 0, 9
"c:\work\Python Projects\helper\pygame_helper\classes\geometry\lines.py", "Python", 0, 0, 11, 0, 11
"c:\work\Python Projects\helper\pygame_helper\classes\geometry\ray.py", "Python", 0, 0, 1, 0, 1
"c:\work\Python Projects\helper\pygame_helper\classes\sprites\__init__.py", "Python", 0, 0, 0, 1, 1
"c:\work\Python Projects\helper\pygame_helper\classes\sprites\animated.py", "Python", -56, 0, -18, -20, -94
"c:\work\Python Projects\helper\pygame_helper\classes\sprites\components.py", "Python", 11, 0, 0, 1, 12
"c:\work\Python Projects\helper\pygame_helper\classes\sprites\sprite.py", "Python", 59, 0, 23, 30, 112
"c:\work\Python Projects\helper\pygame_helper\classes\ui\__init__.py", "Python", 0, 0, 0, 1, 1
"c:\work\Python Projects\helper\pygame_helper\classes\ui\buttons.py", "Python", 27, 0, 0, 10, 37
"c:\work\Python Projects\helper\pygame_helper\classes\ui\checkbox.py", "Python", 51, 0, 0, 14, 65
"c:\work\Python Projects\helper\pygame_helper\classes\ui\dropdown.py", "Python", 102, 0, 0, 20, 122
"c:\work\Python Projects\helper\pygame_helper\classes\ui\group.py", "Python", 28, 0, 0, 10, 38
"c:\work\Python Projects\helper\pygame_helper\classes\ui\image.py", "Python", 11, 0, 0, 4, 15
"c:\work\Python Projects\helper\pygame_helper\classes\ui\inputbox.py", "Python", 15, 0, 0, 5, 20
"c:\work\Python Projects\helper\pygame_helper\classes\ui\slider.py", "Python", 104, 0, 0, 20, 124
"c:\work\Python Projects\helper\pygame_helper\classes\ui\statusbar.py", "Python", 24, 0, 0, 3, 27
"c:\work\Python Projects\helper\pygame_helper\classes\ui\text.py", "Python", 32, 0, 0, 9, 41
"c:\work\Python Projects\helper\pygame_helper\classes\ui\window.py", "Python", 54, 0, 0, 13, 67
"c:\work\Python Projects\helper\pygame_helper\classes\ui\window_stack.py", "Python", 42, 0, 0, 12, 54
"c:\work\Python Projects\helper\pygame_helper\debug.py", "Python", 54, 0, 3, 8, 65
"c:\work\Python Projects\helper\pygame_helper\events\__init__.py", "Python", 0, 0, 0, 1, 1
"c:\work\Python Projects\helper\pygame_helper\events\events.py", "Python", 18, 0, 0, 4, 22
"c:\work\Python Projects\helper\pygame_helper\graphics\__init__.py", "Python", 0, 0, 0, 1, 1
"c:\work\Python Projects\helper\pygame_helper\helper.py", "Python", -9, 0, -4, -3, -16
"c:\work\Python Projects\helper\pygame_helper\test.py", "Python", 21, 0, 0, 7, 28
"Total", "-", 762, 1, 117, 187, 1067