"filename", "language", "Python", "Markdown", "comment", "blank", "total"
"c:\work\Python Projects\helper\pygame_helper\README.md", "Markdown", 0, 1, 0, 1, 2
"c:\work\Python Projects\helper\pygame_helper\__init__.py", "Python", 0, 0, 0, 1, 1
"c:\work\Python Projects\helper\pygame_helper\_utils.py", "Python", 12, 0, 13, 4, 29
"c:\work\Python Projects\helper\pygame_helper\classes\__init__.py", "Python", 0, 0, 0, 1, 1
"c:\work\Python Projects\helper\pygame_helper\classes\animations\animation_action.py", "Python", 45, 0, 14, 5, 64
"c:\work\Python Projects\helper\pygame_helper\classes\animations\animation_step.py", "Python", 28, 0, 11, 7, 46
"c:\work\Python Projects\helper\pygame_helper\classes\animations\transform_animation.py", "Python", 101, 0, 37, 18, 156
"c:\work\Python Projects\helper\pygame_helper\classes\background.py", "Python", 24, 0, 18, 11, 53
"c:\work\Python Projects\helper\pygame_helper\classes\effects\__init__.py", "Python", 0, 0, 0, 1, 1
"c:\work\Python Projects\helper\pygame_helper\classes\effects\particles.py", "Python", 203, 0, 59, 63, 325
"c:\work\Python Projects\helper\pygame_helper\classes\effects\trail.py", "Python", 43, 0, 31, 17, 91
"c:\work\Python Projects\helper\pygame_helper\classes\geometry\__init__.py", "Python", 0, 0, 0, 1, 1
"c:\work\Python Projects\helper\pygame_helper\classes\geometry\circle.py", "Python", 108, 0, 66, 33, 207
"c:\work\Python Projects\helper\pygame_helper\classes\geometry\lines.py", "Python", 190, 0, 128, 62, 380
"c:\work\Python Projects\helper\pygame_helper\classes\geometry\ray.py", "Python", 52, 0, 47, 16, 115
"c:\work\Python Projects\helper\pygame_helper\classes\pathfinding.py", "Python", 79, 0, 37, 18, 134
"c:\work\Python Projects\helper\pygame_helper\classes\sprites\__init__.py", "Python", 0, 0, 0, 1, 1
"c:\work\Python Projects\helper\pygame_helper\classes\sprites\animated.py", "Python", 137, 0, 42, 24, 203
"c:\work\Python Projects\helper\pygame_helper\classes\sprites\components.py", "Python", 62, 0, 3, 12, 77
"c:\work\Python Projects\helper\pygame_helper\classes\sprites\groups.py", "Python", 58, 0, 17, 15, 90
"c:\work\Python Projects\helper\pygame_helper\classes\sprites\sprite.py", "Python", 246, 0, 95, 74, 415
"c:\work\Python Projects\helper\pygame_helper\classes\timers.py", "Python", 36, 0, 28, 11, 75
"c:\work\Python Projects\helper\pygame_helper\classes\ui\__init__.py", "Python", 0, 0, 0, 1, 1
"c:\work\Python Projects\helper\pygame_helper\classes\ui\buttons.py", "Python", 110, 0, 24, 39, 173
"c:\work\Python Projects\helper\pygame_helper\classes\ui\checkbox.py", "Python", 51, 0, 0, 14, 65
"c:\work\Python Projects\helper\pygame_helper\classes\ui\dropdown.py", "Python", 102, 0, 0, 20, 122
"c:\work\Python Projects\helper\pygame_helper\classes\ui\group.py", "Python", 75, 0, 0, 18, 93
"c:\work\Python Projects\helper\pygame_helper\classes\ui\image.py", "Python", 31, 0, 0, 12, 43
"c:\work\Python Projects\helper\pygame_helper\classes\ui\inputbox.py", "Python", 117, 0, 30, 19, 166
"c:\work\Python Projects\helper\pygame_helper\classes\ui\slider.py", "Python", 104, 0, 0, 20, 124
"c:\work\Python Projects\helper\pygame_helper\classes\ui\statusbar.py", "Python", 101, 0, 0, 20, 121
"c:\work\Python Projects\helper\pygame_helper\classes\ui\text.py", "Python", 109, 0, 9, 27, 145
"c:\work\Python Projects\helper\pygame_helper\classes\ui\window.py", "Python", 56, 0, 0, 14, 70
"c:\work\Python Projects\helper\pygame_helper\classes\ui\window_stack.py", "Python", 42, 0, 0, 12, 54
"c:\work\Python Projects\helper\pygame_helper\debug.py", "Python", 54, 0, 3, 8, 65
"c:\work\Python Projects\helper\pygame_helper\events\__init__.py", "Python", 0, 0, 0, 1, 1
"c:\work\Python Projects\helper\pygame_helper\events\events.py", "Python", 80, 0, 21, 19, 120
"c:\work\Python Projects\helper\pygame_helper\events\input.py", "Python", 13, 0, 0, 2, 15
"c:\work\Python Projects\helper\pygame_helper\graphics\__init__.py", "Python", 0, 0, 0, 1, 1
"c:\work\Python Projects\helper\pygame_helper\graphics\color.py", "Python", 317, 0, 38, 17, 372
"c:\work\Python Projects\helper\pygame_helper\graphics\surface.py", "Python", 50, 0, 11, 13, 74
"c:\work\Python Projects\helper\pygame_helper\graphics\utils.py", "Python", 24, 0, 31, 4, 59
"c:\work\Python Projects\helper\pygame_helper\graphics\window.py", "Python", 26, 0, 20, 8, 54
"c:\work\Python Projects\helper\pygame_helper\helper.py", "Python", 58, 0, 20, 11, 89
"c:\work\Python Projects\helper\pygame_helper\saving.py", "Python", 71, 0, 25, 7, 103
"c:\work\Python Projects\helper\pygame_helper\test.py", "Python", 35, 0, 0, 17, 52
"Total", "-", 3050, 1, 878, 720, 4649